N.BASES;Nombre la base ;total de observaciones;filas(observaciones);variables;total de valores en la matriz de   similaridad;Rchic total similaridad;Pchic total similaridad;cant .valores no similares ;porcentaje de valores similares entre 2 matrices;porcentaje de no similaridad;decimales 6pchic  y 7 rchic;nodospchic ;nodosrchic;porcentaje nodos iguales;dendogramas r chic;dendrograma pchic;Rchic total similaridad(6);Pchic total similaridad(6);cant .valores no similares ;porcentaje de valores similares(6);porcentaje de no similaridad
1;natallyFile_130_C78700xV600;47220000;78700;600;360000;179700;179101;599;0.997;0.003;7;38;38;1;1;1;179700;179700;0;1;0
2;natallyFILE_128_C62600xV300;18780000;62600;300;90000;44850;44551;299;0.993;0.007;7;34;35;0.97143;1;1;44850;44850;0;1;0
3;natallyFile_137_C67500xV800;54000000;67500;800;640000;319600;318801;799;0.998;0.002;7;35;36;0.97222;1;1;319600;319600;0;1;0
4;natallyFile_144_C4700xV300;1410000;4700;300;90000;44850;44551;299;0.993;0.0067;7;36;37;0.97297;1;1;44850;44850;0;1;0
5;natallyFile_149_C10900xV300;3270000;10900;300;90000;44850;44551;299;0.993;0.0067;7;36;36;1;1;1;44850;44850;0;1;0
6;natallyFile_159_C80700xV3;242100;80700;3;9;3;3;0;1;0;7;1;1;1;1;1;3;3;0;1;0
7;natallyFile_162_C26300xV500;13150000;26300;500;250000;124750;124251;499;0.996;0.004;7;36;36;1;1;1;124750;124750;0;1;0
8;natallyFile_204_C32300xV900;29070000;32300;900;810000;404550;403651;899;0.998;0.0022;7;37;38;0.97368;1;1;404550;404550;0;1;0
9;natallyFile_185_C18200xV300;5460000;18200;300;90000;44850;44551;299;0.993;0.0067;7;37;38;0.97368;1;1;44850;44850;0;1;0
10;natallyFile_212_C4000xV38;152000;4000;38;1444;703;703;0;1;0;7;10;10;1;1;1;703;703;0;1;0
11;natallyFile_169_C33000xV200;6600000;33000;200;40000;19900;19701;199;0.99;0.01;7;36;39;0.92308;1;1;19900;19900;0;1;0
12;natallyFile_192_C20500xV1200;24600000;20500;1200;1440000;719400;718201;1199;0.9983;0.0017;7;38;40;0.95;1;1;719400;719400;0;1;0
13;natallyFile_237_C94400xV300;28320000;94400;300;90000;44850;44551;299;0.9933;0.0067;7;35;37;0.94595;1;1;44850;44850;0;1;0
14;natallyFile_242_C55500xV100;5550000;55500;100;10000;4950;4851;99;0.98;0.02;7;20;21;0.95238;1;1;4950;4950;0;1;0
15;natallyFile_250_C33200xV400;13280000;33200;400;160000;79800;79401;399;0.995;0.005;7;37;40;0.925;1;1;79800;79800;0;1;0
16;natallyFile_279_C1400xV900;1260000;1400;900;810000;404550;403651;899;0.998;0.0022;7;38;40;0.95;1;1;404550;404550;0;1;0
17;natallyFile_382_C65900xV300;19770000;65900;300;90000;44850;44551;299;0.9933;0.0067;7;37;38;0.97368;1;1;44850;44850;0;1;0
18;natallyFile_410_C13800xV400;5520000;13800;400;160000;79800;79401;399;1;0.01;7;38;38;1;1;1;79800;79800;0;1;0
19;natallyFile_419_C81900xV11;900900;81900;11;121;55;55;0;1;0;7;2;2;1;1;1;55;55;0;1;0
20;natallyFile_426_C33500xV100;3350000;33500;100;10000;4950;4851;99;0.98;0.02;7;35;36;0.97222;1;1;4950;4950;0;1;0
21;natallyFile_435_C33700xV100;3370000;33700;100;10000;4950;4851;99;0.98;0.02;7;38;40;0.95;1;1;4950;4950;0;1;0
22;natallyFile_358_C77900xV1100;85690000;77900;1100;1210000;604450;601149;3301;0.9945;0.0055;7;38;40;0.95;1;1;604450;604450;0;1;0
23;natallyFile_371_C75100xV600;45060000;75100;600;360000;179700;179101;599;0.9967;0.0033;7;38;40;0.95;1;1;179700;179700;0;1;0
24;natallyFile_442_C82500xV500;41250000;82500;500;250000;124750;124251;499;0.996;0.004;7;38;39;0.97436;1;1;124750;124750;0;1;0
25;natallyFile_4_C74300xV3800;282340000;74300;3800;14440000;7218100;7216799;1301;0.9998;0.0002;7;38;40;0.95;1;1;7218100;7218100;0;1;0
26;natallyFile_16_C29700xV9300;276210000;29700;9300;86490000;43240350;43230250;10100;0.9998;0.0002;7;38;40;0.95;1;1;43240350;43240350;0;1;0
27;natallyFile_55_C60000xV4200;252000000;60000;4200;17640000;8817900;8816899;1001;0.9999;0.0001;7;38;40;0.95;1;1;8817900;8817900;0;1;0
28;natallyFile_61_C59900xV4900;293510000;59900;4900;24010000;12002550;12001525;1025;0.9999;0;7;38;40;0.95;1;1;12002550;12002550;0;1;0
29;natallyFile_81_C59900xV4900;293510000;59900;4900;24010000;12002550;12001525;1025;0.9999;0;7;38;40;0.95;1;1;12002550;12002550;0;1;0
30;natallyFile_103_C69300xV4000;277200000;69300;4000;16000000;7998000;7996988;1012;0.9999;0;7;38;40;0.95;1;1;7998000;7998000;0;1;0
31;natallyFile_109_C34100xV8500;289850000;34100;8500;72250000;36120750;36110650;10100;0.99972;0;7;38;40;0.95;1;1;36120750;36120750;0;1;0
32;natallyFile_124_C30000xV9700;291000000;30000;9700;94090000;47040150;47030150;10000;0.9998;0;7;38;40;0.95;1;1;47040150;47040150;0;1;0
33;natallyFile_142_C50400xV5000;252000000;50400;5000;25000000;12497500;12487500;10000;0.9992;0;7;38;40;0.95;1;1;12497500;12497500;0;1;0
34;natallyFile_157_C41300xV6100;251930000;41300;6100;37210000;18601950;18500850;101100;0.9946;0.01;7;38;40;0.95;1;1;18601950;18601950;0;1;0
35;natallyFile_170_C76800xV3300;253440000;76800;3300;10890000;5443350;5433350;10000;0.9982;0.0018;7;38;40;0.95;1;1;5443350;5443350;0;1;0
36;natallyFile_181_C71300xV3500;249550000;71300;3500;12250000;6123250;6111250;12000;1;0;7;38;40;0.95;1;1;6123250;6123250;0;1;0
37;natallyFile_186_C62400xV4200;262080000;62400;4200;17640000;8817900;8815899;2001;0.9998;0;7;38;40;0.95;1;1;8817900;8817900;0;1;0
38;natallyFile_195_C38000xV7200;273600000;38000;7200;51840000;25916400;25915399;1001;0.99996;0;7;38;40;0.95;1;1;25916400;25916400;0;1;0
39;natallyFile_205_C73300xV4000;293200000;73300;4000;16000000;7998000;7996599;1401;0.9998;0;7;38;40;0.95;1;1;7998000;7998000;0;1;0
40;natallyFile_270_C26100xV9900;258390000;26100;9900;98010000;49000050;48700005;300045;0.9939;0.01;7;38;40;0.95;1;1;49000050;49000050;0;1;0
41;natallyFile_302_C54100xV5400;292140000;54100;5400;29160000;14577300;14565300;12000;1;0;7;38;40;0.95;1;1;14577300;14577300;0;1;0
42;natallyFile_356_C59900xV4100;245590000;59900;4100;16810000;8402950;8401850;1100;1;0;7;38;40;0.95;1;1;8402950;8402950;0;1;0
43;natallyFile_432_C40200xV6400;257280000;40200;6400;40960000;20476800;20465799;11001;0.9995;0.0005;7;38;40;0.95;1;1;20476800;20476800;0;1;0
44;natallyFile_457_C67400xV3800;256120000;67400;3800;14440000;7218100;7216799;1301;0.9998;0;7;38;40;0.95;1;1;7218100;7218100;0;1;0
45;natallyFile_461_C85400xV3200;273280000;85400;3200;10240000;5118400;5116350;2050;0.9996;0;7;38;40;0.95;1;1;5118400;5118400;0;1;0
46;natallyFile_463_C47700xV5300;252810000;47700;5300;28090000;14042350;14031350;11000;0.9992;0;7;38;40;0.95;1;1;14042350;14042350;0;1;0
47;natallyFile_1_C36000xV8400;302400000;36000;8400;70560000;35275800;35264799;11001;0.99969;0;7;38;39;0.97436;1;1;35275800;35275800;0;1;0
48;natallyFile_2_C25900xV7700;199430000;25900;7700;59290000;29641150;29541040;100110;0.9966;0;7;38;40;0.95;1;1;29641150;29641150;0;1;0
49;natallyFile_4_C74300xV3800;282340000;74300;3800;14440000;7218100;7216799;1301;0.9998;0;7;37;40;0.925;1;1;7218100;7218100;0;1;0
50;natallyFile_5_C65800xV7000;460600000;65800;7000;49000000;24496500;24484550;11950;0.999512;0;7;38;40;0.95;1;1;2760207850;2760207850;0;1;0
51;natallyFile_6_C82400xV2500;206000000;82400;2500;6250000;3123750;3122550;1200;0.9996;0;7;38;40;0.95;1;1;3123750;3123750;0;1;0
52;natallyFile_8_C32200xV4900;157780000;32200;4900;24010000;12002550;12001525;1025;1;0;7;38;40;0.95;1;1;12002550;12002550;0;1;0
53;natallyFile_9_C35600xV1300;46280000;35600;1300;1690000;844350;842455;1895;0.9978;0;7;38;40;0.95;1;1;844350;844350;0;1;0
54;natallyFile_11_C12700xV10000;127000000;12700;10000;100000000;49995000;49984001;10999;1;0;7;36;38;0.94737;1;1;49995000;49995000;0;1;0
55;natallyFile_12_C42800xV2700;115560000;42800;2700;7290000;3643650;3641550;2100;0.9994;0;7;38;40;0.95;1;1;3643650;3643650;0;1;0
56;natallyFile_14_C62800xV7000;439600000;62800;7000;49000000;24496500;24484550;11950;0.9995;0;7;37;40;0.925;1;1;24496500;24496500;0;1;0
57;natallyFile_16_C29700xV9300;276210000;29700;9300;86490000;43240350;41989999;1250351;0.97;0.03;7;38;40;0.95;1;1;43240350;43240350;0;1;0
58;natallyFile_17_C86300xV5800;500540000;86300;5800;33640000;16817100;16716991;100109;0.994;0.006;7;38;40;0.95;1;1;16817100;16817100;0;1;0
59;natallyFile_18_C23800xV5200;123760000;23800;5200;27040000;13517400;13514300;3100;0.9998;0.0002;7;38;40;0.95;1;1;13517400;13517400;0;1;0
60;natallyFile_19_C17400xV8300;144420000;17400;8300;68890000;34440850;34430140;10710;0.9997;0;7;37;40;0.925;1;1;34440850;34440850;0;1;0
61;natallyFile_20_C40800xV8700;354960000;40800;8700;75690000;37840650;37820549;20101;0.9995;0;7;38;40;0.95;1;1;37840650;37840650;0;1;0
62;natallyFile_21_C89400xV3500;312900000;89400;3500;12250000;6123250;6112150;11100;0.9982;0;7;38;40;0.95;1;1;6123250;6123250;0;1;0
63;natallyFile_22_C31500xV7000;220500000;31500;7000;49000000;24496500;24393350;103150;0.996;0;7;38;40;0.95;1;1;24496500;24496500;0;1;0
64;natallyFile_23_C18500xV1500;27750000;18500;1500;2250000;1124250;1121150;3100;0.997;0;7;38;40;0.95;1;1;1124250;1124250;0;1;0
65;natallyFile_38_C3800xV5800;22040000;3800;5800;33640000;16817100;16710991;106109;0.994;0.006;7;35;38;0.92105;1;1;16817100;16817100;0;1;0
66;natallyFile_40_C24200xV1300;31460000;24200;1300;1690000;844350;842249;2101;0.9975;0;7;37;40;0.925;1;1;844350;844350;0;1;0
67;natallyFile_43_C38100xV800;30480000;38100;800;640000;319600;318801;799;1;0;7;38;40;0.95;1;1;319600;319600;0;1;0
68;natallyFile_46_C23600xV1100;25960000;23600;1100;1210000;604450;601149;3301;0.995;0.01;7;38;40;0.95;1;1;604450;604450;0;1;0
69;natallyFile_52_C2900xV1200;3480000;2900;1200;1440000;719400;718201;1199;1;0;7;38;40;0.95;1;1;719400;719400;0;1;0
70;natallyFile_58_C88200xV300;26460000;88200;300;90000;44850;44551;299;0.99;0.01;7;36;39;0.92308;1;1;44850;44850;0;1;0
71;natallyFile_62_C1600xV1500;2400000;1600;1500;2250000;1124250;1121150;3100;1;0;7;38;40;0.95;1;1;1124250;1124250;0;1;0
72;natallyFile_66_C60000xV900;54000000;60000;900;810000;404550;403651;899;1;0;7;38;40;0.95;1;1;404550;404550;0;1;0
73;natallyFile_68_C29900xV300;89700000;29900;3000;9000000;4498500;4495470;3030;0.999;0;7;38;40;0.95;1;1;4498500;4498500;0;1;0
74;natallyFile_69_C12000xV1600;19200000;12000;1600;2560000;1279200;1277025;2175;0.998;0;7;38;40;0.95;1;1;1279200;1279200;0;1;0
75;natallyFile_72_C69700xV600;7200000;12000;600;360000;179700;178001;1699;0.991;0.01;7;38;40;0.95;1;1;179700;179700;0;1;0
76;natallyFile_74_C17900xV2100;37590000;17900;2100;4410000;2203950;2201650;2300;0.999;0;7;38;39;0.97436;1;1;2203950;2203950;0;1;0
77;natallyFile_80_C47900xV1300;62270000;47900;1300;1690000;844350;843250;1100;0.999;0;7;38;40;0.95;1;1;844350;844350;0;1;0
78;natallyFile_82_C1600xV1500;2400000;1600;1500;2250000;1124250;1121150;3100;0.997;0;7;38;40;0.95;1;1;1124250;1124250;0;1;0
79;natallyFile_86_C60000xV900;54000000;60000;900;810000;404550;403651;899;1;0;7;38;40;0.95;1;1;404550;404550;0;1;0
80;natallyFile_88_C29900xV300;8970000;29900;300;90000;44850;44551;299;0.99;0.01;7;39;40;0.975;1;1;44850;44850;0;1;0
81;natallyFile_89_C12000xV1600;19200000;12000;1600;2560000;1279200;1277025;2175;0.998;0;7;38;40;0.95;1;1;1279200;1279200;0;1;0
82;natallyFile_92_C69700xV600;41820000;69700;600;360000;179700;179101;599;1;0;7;38;40;0.95;1;1;179700;179700;0;1;0
83;natallyFile_94_C17900xV2100;37590000;17900;2100;4410000;2203950;2200620;3330;0.998;0;7;38;40;0.95;1;1;2203950;2203950;0;1;0
84;natallyFile_100_C9800xV2200;21560000;9800;2200;4840000;2418900;2413569;5331;0.998;0;7;38;40;0.95;1;1;2418900;2418900;0;1;0
85;natallyFile_100_C47900xV1300;62270000;47900;1300;1690000;844350;843129;1221;0.999;0;7;36;35;1.02857;1;1;844350;844350;0;1;0
86;natallyFile_101_C5100xV9200;46920000;5100;9200;84640000;42315400;41700005;615395;0.99;0.01;7;38;40;0.95;1;1;42315400;42315400;0;1;0
87;natallyFile_107_C44700xV1300;58110000;44700;1300;1690000;844350;843250;1100;1;0;7;38;40;0.95;1;1;844350;844350;0;1;0
88;natallyFile_108_C22200xV2700;59940000;22200;2700;7290000;3643650;3641349;2301;0.999;0;7;38;40;0.95;1;1;3643650;3643650;0;1;0
89;natallyFile_110_C3300xV4400;14520000;3300;4400;19360000;9677800;9664199;13601;0.999;0;7;38;40;0.95;1;1;9677800;9677800;0;1;0
90;natallyFile_113_C5500xV9200;50600000;5500;9200;84640000;42315400;41700005;615395;0.99;0.01;7;38;40;0.95;1;1;42315400;42315400;0;1;0
91;natallyFile_121_C2000xV9300;18600000;2000;9300;86490000;43240350;42800005;440345;0.9898;0.01;7;38;40;0.95;1;1;43240350;43240350;0;1;0
92;natallyFile_129_C41500xV1600;2400000;1500;1600;2560000;1279200;1268100;11100;0.9913;0.01;7;38;40;0.95;1;1;1279200;1279200;0;1;0
93;natallyFile_140_C16100xV24;386400;16100;24;576;276;276;0;1;0;7;4;5;0.8;1;1;276;276;0;1;0
94;natallyFile_141_C93100xV600;54780000;91300;600;360000;179700;179101;599;1;0;7;36;38;0.94737;1;1;179700;179700;0;1;0
95;natallyFile_144_C4700xV300;1410000;4700;300;90000;44850;44551;299;0.99;0.01;7;38;40;0.95;1;1;44850;44850;0;1;0
96;natallyFile_147_C18300xV3200;58560000;18300;3200;10240000;5118400;5116350;2050;1;0;7;35;38;0.92105;1;1;5118400;5118400;0;1;0
97;natallyFile_156_C47000xV1100;51700000;47000;1100;1210000;604450;604000;450;1;0;7;38;40;0.95;1;1;604450;604450;0;1;0
98;natallyFile_182_C12900xV4200;54180000;12900;4200;17640000;8817900;8815899;2001;1;0;7;38;40;0.95;1;1;8817900;8817900;0;1;0
99;natallyFile_185_C18200xV300;5460000;18200;300;90000;44850;44551;299;0.99;0.01;7;34;36;0.94444;1;1;44850;44850;0;1;0
100;natallyFile_192_C20500xV1200;24600000;20500;1200;1440000;719400;718201;1199;1;0;7;38;40;0.95;1;1;719400;719400;0;1;0
101;natallyFile_198_C3400xV1500;5100000;3400;1500;2250000;1124250;1121150;3100;1;0;7;38;40;0.95;1;1;1124250;1124250;0;1;0
102;natallyFile_204_C32300xV900;29070000;32300;900;810000;404550;403651;899;1;0;7;38;40;0.95;1;1;404550;404550;0;1;0
103;natallyFile_211_C8300xV3900;32370000;8300;3900;15210000;7603050;7602600;450;0.99994;0.00006;7;38;40;0.95;1;1;7603050;7603050;0;1;0
104;natallyFile_227_C6300xV1000;6300000;6300;1000;1000000;499500;498459;1041;0.998;0;7;38;40;0.95;1;1;499500;499500;0;1;0
105;natallyFile_232_C5500xV9100;50050000;5500;9100;82810000;41400450;41300349;100101;0.998;0;7;38;40;0.95;1;1;41400450;41400450;0;1;0
106;natallyFile_240_C94400xV300;28320000;94400;300;90000;44850;44551;299;0.99;0.01;7;38;40;0.95;1;1;44850;44850;0;1;0
107;natallyFile_243_C55500xV100;5550000;55500;100;10000;4950;4851;99;0.98;0.02;7;38;40;0.95;1;1;4950;4950;0;1;0
108;natallyFile_248_C45100xV1300;58630000;45100;1300;1690000;844350;843129;1221;1;0;7;38;40;0.95;1;1;844350;844350;0;1;0
109;natallyFile_250_C33200xV400;13280000;33200;400;160000;79800;79401;399;1;0.01;7;38;40;0.95;1;1;79800;79800;0;1;0
110;natallyFile_258_C17100xV3500;59850000;17100;3500;12250000;6123250;6111250;12000;1;0;7;38;40;0.95;1;1;6123250;6123250;0;1;0
111;natallyFile_259_C17100xV3500;59850000;17100;3500;12250000;6123250;6111250;12000;1;0;7;38;40;0.95;1;1;6123250;6123250;0;1;0
112;natallyFile_265_C4300xV9300;39990000;4300;9300;86490000;43240350;41989999;1250351;0.97;0.03;7;38;40;0.95;1;1;43240350;43240350;0;1;0
113;natallyFile_271_C71900xV400;28760000;71900;400;160000;79800;79401;399;1;0.01;7;38;40;0.95;1;1;79800;79800;0;1;0
114;natallyFile_279_C1400xV900;12600000;14000;900;810000;404550;403651;899;1;0;7;38;40;0.95;1;1;404550;404550;0;1;0
115;natallyFile_283_C5400xV100;5400000;54000;100;10000;4950;4851;99;0.98;0.02;7;37;40;0.925;1;1;4950;4950;0;1;0
116;natallyFile_291_C16600xV1300;21580000;16600;1300;1690000;844350;843129;1221;1;0;7;38;40;0.95;1;1;844350;844350;0;1;0
117;natallyFile_293_C2000xV1900;3800000;2000;1900;3610000;1804050;1801199;2851;0.998;0;7;38;40;0.95;1;1;1804050;1804050;0;1;0
118;natallyFile_295_C4500xV6200;27900000;4500;6200;38440000;19216900;19210400;6500;0.9997;0;7;38;40;0.95;1;1;19216900;19216900;0;1;0
119;natallyFile_298_C2200xV6100;13420000;2200;6100;37210000;18601950;18500100;101850;0.99452;0.005;7;38;40;0.95;1;1;18601950;18601950;0;1;0
120;natallyFile_301_C7400xV6400;47360000;7400;6400;40960000;20476800;20465799;11001;1;0;7;38;40;0.95;1;1;20476800;20476800;0;1;0
121;natallyFile_351_C5800xV8900;51620000;5800;8900;79210000;39600550;39510650;89900;0.9977;0.0023;7;38;40;0.95;1;1;39600550;39600550;0;1;0
122;natallyFile_353_C1200xV5000;6000000;1200;5000;25000000;12497500;12487500;10000;1;0;7;38;40;0.95;1;1;12497500;12497500;0;1;0
123;natallyFile_360_C1400xV9500;126350000;13300;9500;90250000;45120250;45100159;20091;0.9996;0;7;36;37;0.97297;1;1;45120250;45120250;0;1;0
124;natallyFile_361_C13300xV1200;15960000;13300;1200;1440000;719400;718201;1199;1;0;7;38;40;0.95;1;1;719400;719400;0;1;0
125;natallyFile_370_C1200xV6500;7800000;1200;6500;42250000;21121750;21110599;11151;0.999;0;7;38;40;0.95;1;1;21121750;21121750;0;1;0
126;natallyFile_371_C75100xV600;45060000;75100;600;360000;179700;179101;599;1;0;7;38;40;0.95;1;1;179700;179700;0;1;0
127;natallyFile_375_C4000xV2700;10800000;4000;2700;7290000;3643650;3631349;12301;0.997;0;7;38;40;0.95;1;1;3643650;3643650;0;1;0
128;natallyFile_379_C8800xV7600;66880000;8800;7600;57760000;28876200;28846100;30100;0.999;0.001;7;38;40;0.95;1;1;28876200;28876200;0;1;0
129;natallyFile_380_C5000xV4500;22500000;5000;4500;20250000;10122750;10111499;11251;0.999;0;7;38;40;0.95;1;1;10122750;10122750;0;1;0
130;natallyFile_382_C65900xV300;19770000;65900;300;90000;44850;44551;299;0.99;0.01;7;38;40;0.95;1;1;44850;44850;0;1;0
131;natallyFile_380_C5000xV4500;22500000;5000;4500;20250000;10122750;10111499;11251;1;0;7;38;40;0.95;1;1;10122750;10122750;0;1;0
132;natallyFile_382_C65900xV300;19770000;65900;300;90000;44850;44551;299;0.99;0.01;7;38;40;0.95;1;1;44850;44850;0;1;0
133;natallyFile_386_C2400xV4400;10560000;2400;4400;19360000;9677800;9645900;31900;0.997;0;7;38;40;0.95;1;1;9677800;9677800;0;1;0
134;natallyFile_389_C1900xV6200;11780000;1900;6200;38440000;19216900;19210400;6500;1;0;7;38;40;0.95;1;1;19216900;19216900;0;1;0
135;natallyFile_410_C13800xV400;5520000;13800;400;160000;79800;79401;399;0.995;0.005;7;38;40;0.95;1;1;79800;79800;0;1;0
136;natallyFile_415_C11000xV5200;57200000;11000;5200;27040000;13517400;13514300;3100;1;0;7;38;40;0.95;1;1;13517400;13517400;0;1;0
137;natallyFile_419_C81900xV11;9009000;819000;11;121;55;55;0;1;0;7;38;40;0.95;1;1;55;55;0;1;0
138;natallyFile_423_C26800xV2200;58960000;26800;2200;4840000;2418900;2413569;5331;1;0;7;38;40;0.95;1;1;2418900;2418900;0;1;0
139;natallyFile_426_C33500xV100;3350000;33500;100;10000;4950;4851;99;0.98;0.02;7;38;40;0.95;1;1;4950;4950;0;1;0
140;natallyFile_435_C33700xV100;3370000;33700;100;10000;4950;4851;99;0.98;0.02;7;38;40;0.95;1;1;4950;4950;0;1;0
141;natallyFile_438_C23400xV1900;44460000;23400;1900;3610000;1804050;1801199;2851;1;0;7;38;40;0.95;1;1;1804050;1804050;0;1;0
142;natallyFile_442_C82500xV500;41250000;82500;500;250000;124750;124251;499;0.996;0;7;38;40;0.95;1;1;124750;124750;0;1;0
143;natallyFile_444_C500xV9600;4800000;500;9600;92160000;46075200;46043199;32001;0.999;0;7;38;40;0.95;1;1;46075200;46075200;0;1;0
144;natallyFile_445_C200xV9300;1860000;200;9300;86490000;43240350;43139149;101201;0.998;0;7;38;40;0.95;1;1;43240350;43240350;0;1;0
145;natallyFile_453_C89900xV600;53940000;89900;600;360000;179700;179101;599;1;0;7;38;40;0.95;1;1;179700;179700;0;1;0
146;natallyFile_456_C83000xV100;8300000;83000;100;10000;4950;4851;99;0.98;0.02;7;38;40;0.95;1;1;4950;4950;0;1;0
147;natallyFile_465_C18600xV2400;446400000;186000;2400;5760000;2878800;2871679;7121;0.998;0;7;38;40;0.95;1;1;2878800;2878800;0;1;0
148;natallyFile_473_C17100xV400;6840000;17100;400;160000;79800;79401;399;1;0.01;7;38;40;0.95;1;1;79800;79800;0;1;0
149;natallyFile_8_C32200xV4900;1577800000;322000;4900;24010000;12002550;12001525;1025;1;0;7;38;40;0.95;1;1;12002550;12002550;0;1;0
150;natallyFile_11_C12700xV10000;127000000;12700;10000;100000000;49995000;49875479;119521;0.998;0;7;38;40;0.95;1;1;49995000;49995000;0;1;0
151;natallyFile_12_C42800xV2700;115560000;42800;2700;7290000;3643650;3631649;12001;0.997;0;7;38;40;0.95;1;1;3643650;3643650;0;1;0
152;natallyFile_18_C23800xV5200;123760000;23800;5200;27040000;13517400;13514300;3100;1;0;7;38;40;0.95;1;1;13517400;13517400;0;1;0
153;natallyFile_19_C17400xV8300;144420000;17400;8300;68890000;34440850;34430649;10201;1;0;7;38;40;0.95;1;1;34440850;34440850;0;1;0
154;natallyFile_25_C39200xV2700;105840000;39200;2700;7290000;3643650;3631349;12301;1;0;7;38;40;0.95;1;1;3643650;3643650;0;1;0
155;natallyFile_30_C80700xV1500;121050000;80700;1500;2250000;1124250;1121150;3100;1;0;7;38;40;0.95;1;1;1124250;1124250;0;1;0
156;natallyFile_71_C12200xV7500;91650000;12220;7500;56250000;28121250;28019150;102100;0.996;0;7;38;40;0.95;1;1;28121250;28121250;0;1;0
157;natallyFile_78_C41900xV2600;108940000;41900;2600;6760000;3378700;3376300;2400;0.9993;0;7;38;40;0.95;1;1;3378700;3378700;0;1;0
158;natallyFile_91_C12200xV7500;91500000;12200;7500;56250000;28121250;28019150;102100;1;0;7;38;40;0.95;1;1;28121250;28121250;0;1;0
159;natallyFile_98_C41900xV2600;108940000;41900;2600;6760000;3378700;3376300;2400;1;0;7;38;40;0.95;1;1;3378700;3378700;0;1;0
160;natallyFile_104_C47800xV2100;100380000;47800;2100;4410000;2203950;2200620;3330;1;0;7;38;40;0.95;1;1;2203950;2203950;0;1;0
161;natallyFile_125_C12100xV8600;104060000;12100;8600;73960000;36975700;36964601;11099;1;0;7;38;40;0.95;1;1;36975700;36975700;0;1;0
162;natallyFile_145_C59100xV1600;94560000;59100;1600;2560000;1279200;1268100;11100;0.99;0.01;7;38;40;0.95;1;1;1279200;1279200;0;1;0
163;natallyFile_151_C35100xV3500;122850000;35100;3500;12250000;6123250;6111250;12000;1;0;7;38;40;0.95;1;1;6123250;6123250;0;1;0
164;natallyFile_154_C61700xV2200;135740000;61700;2200;4840000;2418900;2413569;5331;1;0;7;38;40;0.95;1;1;2418900;2418900;0;1;0
165;natallyFile_155_C56000xV1800;44800000;56000;800;640000;319600;318801;799;1;0;7;38;40;0.95;1;1;319600;319600;0;1;0
166;natallyFile_171_C18900xV5900;111510000;18900;5900;34810000;17402050;17391545;10505;0.999;0;7;38;40;0.95;1;1;17402050;17402050;0;1;0
167;natallyFile_175_C31300xV4900;153370000;31300;4900;24010000;12002550;11991399;11151;0.999;0;7;38;40;0.95;1;1;12002550;12002550;0;1;0
168;natallyFile_179_C33200xV3900;129480000;33200;3900;15210000;7603050;7596988;6062;0.999;0;7;38;40;0.95;1;1;7603050;7603050;0;1;0
169;natallyFile_184_C23900xV5100;121890000;23900;5100;26010000;13002450;13001019;1431;1;0;7;38;40;0.95;1;1;13002450;13002450;0;1;0
170;natallyFile_196_C16100xV7900;127190000;16100;7900;62410000;31201050;31166950;34100;0.999;0;7;38;40;0.95;1;1;31201050;31201050;0;1;0
171;natallyFile_201_C12300xV7800;95940000;12300;7800;60840000;30416100;30312110;103990;0.997;0;7;38;40;0.95;1;1;30416100;30416100;0;1;0
172;natallyFile_206_C81400xV1800;146520000;81400;1800;3240000;1619100;1607199;11901;0.993;0.01;7;38;40;0.95;1;1;1619100;1619100;0;1;0
173;natallyFile_214_C15400xV9700;149380000;15400;9700;94090000;47040150;47020149;20001;1;0;7;38;40;0.95;1;1;47040150;47040150;0;1;0
174;natallyFile_223_C81700xV1200;98040000;81700;1200;1440000;719400;718201;1199;1;0;7;38;40;0.95;1;1;719400;719400;0;1;0
175;natallyFile_228_C31500xV3900;122850000;31500;3900;15210000;7603050;7592000;11050;0.999;0;7;38;40;0.95;1;1;7603050;7603050;0;1;0
176;natallyFile_238_C35900xV4700;168730000;35900;4700;22090000;11042650;11041650;1000;1;0;7;38;40;0.95;1;1;11042650;11042650;0;1;0
177;natallyFile_243_C39200xV4400;172480000;39200;4400;19360000;9677800;9665799;12001;0.999;0;7;38;40;0.95;1;1;9677800;9677800;0;1;0
178;natallyFile_260_C41900xV2200;92180000;41900;2200;4840000;2418900;2411649;7251;0.997;0;7;38;40;0.95;1;1;2418900;2418900;0;1;0
179;natallyFile_266_C18600xV8900;165540000;18600;8900;79210000;39600550;39510650;89900;1;0;7;38;40;0.95;1;1;39600550;39600550;0;1;0
180;natallyFile_267_C20800xV7500;156000000;20800;7500;56250000;28121250;28101104;20146;0.999;0;7;38;40;0.95;1;1;28121250;28121250;0;1;0
181;natallyFile_269_C24500xV6600;161700000;24500;6600;43560000;21776700;21765699;11001;0.9995;0;7;38;40;0.95;1;1;21776700;21776700;0;1;0
182;natallyFile_275_C34400xV5000;172000000;34400;5000;25000000;12497500;12485499;12001;0.999;0;7;38;40;0.95;1;1;12497500;12497500;0;1;0
183;natallyFile_278_C84200xV2000;168400000;84200;2000;4000000;1999000;1991119;7881;0.996;0;7;38;40;0.95;1;1;1999000;1999000;0;1;0
184;natallyFile_286_C25700xV5000;128500000;25700;5000;25000000;12497500;12487500;10000;0.999;0;7;38;40;0.95;1;1;12497500;12497500;0;1;0
185;natallyFile_287_C33900xV4600;155940000;33900;4600;21160000;10577700;10465799;111901;0.99;0.01;7;37;40;0.925;1;1;10577700;10577700;0;1;0
186;natallyFile_289_C80600xV1500;120900000;80600;1500;2250000;1124250;1121150;3100;1;0;7;38;40;0.95;1;1;1124250;1124250;0;1;0
187;natallyFile_357_C42000xV2300;96600000;42000;2300;5290000;2643850;2641739;2111;0.999;0;7;38;40;0.95;1;1;2643850;2643850;0;1;0
188;natallyFile_363_C60000xV2000;1200000000;600000;2000;4000000;1999000;1979899;19101;0.99;0.01;7;38;40;0.95;1;1;1999000;1999000;0;1;0
189;natallyFile_365_C45300xV3200;144960000;45300;3200;10240000;5118400;5109300;9100;0.998;0;7;38;40;0.95;1;1;5118400;5118400;0;1;0
190;natallyFile_367_C23000xV6300;144900000;23000;6300;39690000;19841850;19831450;10400;0.999;0;7;38;40;0.95;1;1;19841850;19841850;0;1;0
191;natallyFile_374_C82500xV1800;148500000;82500;1800;3240000;1619100;1613991;5109;0.997;0;7;39;40;0.975;1;1;1619100;1619100;0;1;0
192;natallyFile_378_C99600xV1100;109560000;99600;1100;1210000;604450;603250;1200;0.998;0;7;38;41;0.92683;1;1;604450;604450;0;1;0
193;natallyFile_384_C53600xV2100;112560000;53600;2100;4410000;2203950;2201149;2801;0.999;0;7;38;40;0.95;1;1;2203950;2203950;0;1;0
194;natallyFile_388_C15600xV7100;110760000;15600;7100;50410000;25201450;25160320;41130;0.998;0;7;38;40;0.95;1;1;25201450;25201450;0;1;0
195;natallyFile_397_C21700xV5400;117180000;21700;5400;29160000;14577300;14547099;30201;0.998;0;7;38;40;0.95;1;1;14577300;14577300;0;1;0
196;natallyFile_400_C17900xV6000;107400000;17900;6000;36000000;17997000;17975691;21309;0.999;0;7;38;40;0.95;1;1;17997000;17997000;0;1;0
197;natallyFile_402_C96200xV1500;144300000;96200;1500;2250000;1124250;1121150;3100;1;0;7;38;40;0.95;1;1;1124250;1124250;0;1;0
198;natallyFile_406_C15900xV8900;141510000;15900;8900;79210000;39600550;39511549;89001;0.998;0;7;38;40;0.95;1;1;39600550;39600550;0;1;0
199;natallyFile_414_C31700xV3900;123630000;31700;3900;15210000;7603050;7591600;11450;0.9985;0;7;37;40;0.925;1;1;7603050;7603050;0;1;0
200;natallyFile_421_C21300xV8000;170400000;21300;8000;64000000;31996000;31985100;10900;0.9997;0;7;38;40;0.95;1;1;31996000;31996000;0;1;0
201;natallyFile_427_C54300xV1900;103170000;54300;1900;3610000;1804050;1801199;2851;1;0;7;38;40;0.95;1;1;1804050;1804050;0;1;0
202;natallyFile_441_C32200xV5100;164220000;32200;5100;26010000;13002450;13000100;2350;0.9998;0.0002;7;38;40;0.95;1;1;13002450;13002450;0;1;0
203;natallyFile_454_C50500xV1900;95950000;50500;1900;3610000;1804050;1801199;2851;0.998;0;7;38;40;0.95;1;1;1804050;1804050;0;1;0
204;natallyFile_455_C28100xV4200;118020000;28100;4200;17640000;8817900;8815899;2001;1;0;7;38;40;0.95;1;1;8817900;8817900;0;1;0
205;natallyFile_459_C35700xV2900;103530000;35700;2900;8410000;4203550;4200599;2951;0.999;0;7;38;40;0.95;1;1;4203550;4203550;0;1;0
206;natallyFile_7_C76500xV7200;550800000;76500;7200;51840000;25916400;25910399;6001;0.9998;0;7;38;40;0.95;1;1;25916400;25916400;0;1;0
207;natallyFile_37_C64700xV6400;414080000;64700;6400;40960000;20476800;20465799;11001;1;0;7;38;40;0.95;1;1;20476800;20476800;0;1;0
208;natallyFile_54_C66300xV8500;563550000;66300;8500;72250000;36120750;36110650;10100;1;0;7;38;40;0.95;1;1;36120750;36120750;0;1;0
209;natallyFile_60_C66700xV6100;406870000;66700;6100;37210000;18601950;18500100;101850;0.99;0.01;7;38;40;0.95;1;1;18601950;18601950;0;1;0
210;natallyFile_64_C60200xV9400;565880000;60200;9400;88360000;44175300;44102399;72901;0.998;0;7;38;40;0.95;1;1;44175300;44175300;0;1;0
211;natallyFile_127_C65000xV6600;429000000;65000;6600;43560000;21776700;21765699;11001;1;0;7;38;40;0.95;1;1;21776700;21776700;0;1;0
212;natallyFile_226_C77200xV7100;548120000;77200;7100;50410000;25201450;25160320;41130;1;0;7;38;40;0.95;1;1;25201450;25201450;0;1;0
213;natallyFile_227_C77200xV7100;548120000;77200;7100;50410000;25201450;25160320;41130;1;0;7;38;40;0.95;1;1;25201450;25201450;0;1;0
214;natallyFile_251_C59500xV9300;553350000;59500;9300;86490000;43240350;43139149;101201;1;0;7;38;40;0.95;1;1;43240350;43240350;0;1;0
215;natallyFile_261_C84900xV6600;560340000;84900;6600;43560000;21776700;21765699;11001;1;0;7;38;40;0.95;1;1;21776700;21776700;0;1;0
216;natallyFile_285_C71300xV6000;427800000;71300;6000;36000000;17997000;17975691;21309;1;0;7;38;40;0.95;1;1;17997000;17997000;0;1;0
217;natallyFile_288_C58600xV9600;562560000;58600;9600;92160000;46075200;46043199;32001;1;0;7;38;40;0.95;1;1;46075200;46075200;0;1;0
218;natallyFile_354_C73100xV7600;555560000;73100;7600;57760000;28876200;28855199;21001;0.9993;0;7;38;40;0.95;1;1;28876200;28876200;0;1;0
219;natallyFile_364_C93200xV5800;540560000;93200;5800;33640000;16817100;16716991;100109;0.99;0.01;7;38;40;0.95;1;1;16817100;16817100;0;1;0
220;natallyFile_365_C73100xV7600;555560000;73100;7600;57760000;28876200;28855199;21001;1;0;7;38;40;0.95;1;1;28876200;28876200;0;1;0
221;natallyFile_367_C93200xV5800;540560000;93200;5800;33640000;16817100;16716991;100109;0.99;0.01;7;38;40;0.95;1;1;16817100;16817100;0;1;0
222;natallyFile_475_C78600xV5200;408720000;78600;5200;27040000;13517400;13514300;3100;1;0;7;38;40;0.95;1;1;13517400;13517400;0;1;0
223;natallyFile_478_C54900xV7500;411750000;54900;7500;56250000;28121250;28101104;20146;1;0;7;38;40;0.95;1;1;28121250;28121250;0;1;0
224;natallyFile_476_C60300xV4900;295470000;60300;4900;24010000;12002550;11991399;11151;1;0;7;38;40;0.95;1;1;12002550;12002550;0;1;0
225;natallyFile_479_C43200xV8500;367200000;43200;8500;72250000;36120750;36110650;10100;1;0;7;38;40;0.95;1;1;36120750;36120750;0;1;0
226;natallyFile_480_C72700xV7000;508900000;72700;7000;49000000;24496500;24484550;11950;1;0;7;38;40;0.95;1;1;24496500;24496500;0;1;0
227;natallyFile_481_C51800xV9700;502460000;51800;9700;94090000;47040150;47020149;20001;1;0;7;38;40;0.95;1;1;47040150;47040150;0;1;0
228;natallyFile_482_C91100xV2300;209530000;91100;2300;5290000;2643850;2641739;2111;1;0;7;38;40;0.95;1;1;2643850;2643850;0;1;0
229;natallyFile_483_C75500xV6400;483200000;75500;6400;40960000;20476800;20465799;11001;1;0;7;38;40;0.95;1;1;20476800;20476800;0;1;0
230;natallyFile_485_C75400xV2400;180960000;75400;2400;5760000;2878800;2871679;7121;1;0;7;38;40;0.95;1;1;2878800;2878800;0;1;0
231;natallyFile_197_C51000xV8800;448800000;51000;8800;77440000;38715600;38710499;5101;1;0;7;38;40;0.95;1;1;38715600;38715600;0;1;0
232;natallyFile_201_C12300xV7800;95940000;12300;7800;60840000;30416100;30312110;103990;1;0;7;38;40;0.95;1;1;30416100;30416100;0;1;0
233;natallyFile_202_C23900xV7600;181640000;23900;7600;57760000;28876200;28855199;21001;1;0;7;38;40;0.95;1;1;28876200;28876200;0;1;0
234;natallyFile_205_C73300xV4000;293200000;73300;4000;16000000;7998000;7996599;1401;1;0;7;38;40;0.95;1;1;7998000;7998000;0;1;0
235;natallyFile_207_C45100xV1600;72160000;45100;1600;2560000;1279200;1268100;11100;0.99;0.01;7;38;40;0.95;1;1;1279200;1279200;0;1;0
236;natallyFile_209_C22400xV9500;212800000;22400;9500;90250000;45120250;45100159;20091;1;0;7;38;40;0.95;1;1;45120250;45120250;0;1;0
237;natallyFile_210_C70500xV2500;176250000;70500;2500;6250000;3123750;3122550;1200;1;0;7;38;40;0.95;1;1;3123750;3123750;0;1;0
238;natallyFile_213_C7000xV3500;245000000;70000;3500;12250000;6123250;6111250;12000;1;0;7;38;40;0.95;1;1;6123250;6123250;0;1;0
239;natallyFile_214_C54900xV7500;411750000;54900;7500;56250000;28121250;28101104;20146;0.9993;0;7;38;40;0.95;1;1;28121250;28121250;0;1;0
240;natallyFile_215_C6300xV6200;391840000;63200;6200;38440000;19216900;19210400;6500;1;0;7;38;40;0.95;1;1;19216900;19216900;0;1;0
241;natallyFile_216_C58500xV6400;374400000;58500;6400;40960000;20476800;20465799;11001;1;0;7;38;40;0.95;1;1;20476800;20476800;0;1;0
242;natallyFile_217_C52800xV9500;501600000;52800;9500;90250000;45120250;45100159;20091;1;0;7;38;40;0.95;1;1;45120250;45120250;0;1;0
243;natallyFile_218_C86900xV5300;460570000;86900;5300;28090000;14042350;14037349;5001;0.9996;0;7;38;40;0.95;1;1;14042350;14042350;0;1;0
244;natallyFile_219_C54900xV7500;411750000;54900;7500;56250000;28121250;28101104;20146;1;0;7;38;40;0.95;1;1;28121250;28121250;0;1;0
245;natallyFile_220_C70500xV2500;176250000;70500;2500;6250000;3123750;3122550;1200;1;0;7;38;40;0.95;1;1;3123750;3123750;0;1;0
246;natallyFile_221_C86900xV5300;460570000;86900;5300;28090000;14042350;14037349;5001;1;0;7;38;40;0.95;1;1;14042350;14042350;0;1;0
247;natallyFile_222_C54900xV7500;411750000;54900;7500;56250000;28121250;28101104;20146;1;0;7;38;40;0.95;1;1;28121250;28121250;0;1;0
248;natallyFile_223_C81700xV1200;98040000;81700;1200;1440000;719400;718201;1199;1;0;7;38;40;0.95;1;1;719400;719400;0;1;0
249;natallyFile_224_C52600xV3700;194620000;52600;3700;13690000;6843150;6841059;2091;0.9997;0.00031;7;38;40;0.95;1;1;6843150;6843150;0;1;0
250;natallyFile_225_C31500xV3900;122850000;31500;3900;15210000;7603050;7591600;11450;1;0;7;38;40;0.95;1;1;7603050;7603050;0;1;0
251;natallyFile_226_C60700xV3700;224590000;60700;3700;13690000;6843150;6841051;2099;1;0;7;38;40;0.95;1;1;6843150;6843150;0;1;0
252;natallyFile_227_C18200xV9700;176540000;18200;9700;94090000;47040150;47020141;20009;1;0;7;38;40;0.95;1;1;47040150;47040150;0;1;0
253;natallyFile_228_C82900xV2400;198960000;82900;2400;5760000;2878800;2871601;7199;1;0;7;38;40;0.95;1;1;2878800;2878800;0;1;0
254;natallyFile_229_C44600xV8800;392480000;44600;8800;77440000;38715600;38710471;5129;1;0;7;38;40;0.95;1;1;38715600;38715600;0;1;0
255;natallyFile_230_C32900xV4400;144760000;32900;4400;19360000;9677800;9665791;12009;1;0;7;38;40;0.95;1;1;9677800;9677800;0;1;0
256;natallyFile_231_C34500xV7200;248400000;34500;7200;51840000;25916400;25915391;1009;1;0;7;38;40;0.95;1;1;25916400;25916400;0;1;0
257;natallyFile_232_C96200xV4800;461760000;96200;4800;23040000;11517600;11515591;2009;0.9998;0;7;38;40;0.95;1;1;11517600;11517600;0;1;0
258;natallyFile_233_C60700xV3700;224590000;60700;3700;13690000;6843150;6841051;2099;1;0;7;38;40;0.95;1;1;6843150;6843150;0;1;0
259;natallyFile_234_C60200xV8600;517720000;60200;8600;73960000;36975700;36964601;11099;1;0;7;38;40;0.95;1;1;36975700;36975700;0;1;0
260;natallyFile_235_C34200xV8600;294120000;34200;8600;73960000;36975700;36964601;11099;1;0;7;38;40;0.95;1;1;36975700;36975700;0;1;0
261;natallyFile_236_C42100xV8400;353640000;42100;8400;70560000;35275800;35235501;40299;0.9989;0;7;38;40;0.95;1;1;35275800;35275800;0;1;0
262;natallyFile_237_C22500xV8200;184500000;22500;8200;67240000;33615900;33610301;5599;1;0;7;38;40;0.95;1;1;33615900;33615900;0;1;0
263;natallyFile_238_C59000xV6100;359900000;59000;6100;37210000;18601950;18500100;101850;0.995;0.01;7;38;40;0.95;1;1;18601950;18601950;0;1;0
264;natallyFile_239_C41900xV2200;92180000;41900;2200;4840000;2418900;2411649;7251;1;0;7;38;40;0.95;1;1;2418900;2418900;0;1;0
265;natallyFile_240_C78200xV5200;406640000;78200;5200;27040000;13517400;13514300;3100;1;0;7;38;40;0.95;1;1;13517400;13517400;0;1;0
266;natallyFile_241_C82900xV2400;198960000;82900;2400;5760000;2878800;2871679;7121;1;0;7;38;40;0.95;1;1;2878800;2878800;0;1;0
267;natallyFile_242_C18200xV9700;176540000;18200;9700;94090000;47040150;47020149;20001;1;0;7;38;40;0.95;1;1;47040150;47040150;0;1;0
268;natallyFile_243_C60700xV3700;224590000;60700;3700;13690000;6843150;6841051;2099;1;0;7;38;40;0.95;1;1;6843150;6843150;0;1;0
269;natallyFile_244_C61700xV2200;135740000;61700;2200;4840000;2418900;2413569;5331;1;0;7;38;40;0.95;1;1;2418900;2418900;0;1;0
270;natallyFile_245_C56000xV1800;100800000;56000;1800;3240000;1619100;1613991;5109;1;0;7;38;40;0.95;1;1;1619100;1619100;0;1;0
271;natallyFile_246_C47300xV1800;85140000;47300;1800;3240000;1619100;1613991;5109;1;0;7;38;40;0.95;1;1;1619100;1619100;0;1;0
272;natallyFile_247_C59500xV5800;345100000;59500;5800;33640000;16817100;16716991;100109;0.994;0.01;7;38;40;0.95;1;1;16817100;16817100;0;1;0
273;natallyFile_248_C60600xV6700;406020000;60600;6700;44890000;22441650;22430151;11499;1;0;7;38;40;0.95;1;1;22441650;22441650;0;1;0
274;natallyFile_249_C22800xV3800;86640000;22800;3800;14440000;7218100;7216799;1301;1;0;7;38;40;0.95;1;1;7218100;7218100;0;1;0
275;natallyFile_154_C61700xV2200;135740000;61700;2200;4840000;2418900;2411649;7251;1;0;7;38;40;0.95;1;1;2418900;2418900;0;1;0
276;natallyFile_155_C56000xV1800;100800000;56000;1800;3240000;1619100;1607199;11901;0.99;0.01;7;38;40;0.95;1;1;1619100;1619100;0;1;0
277;natallyFile_160_C41300xV6100;251930000;41300;6100;37210000;18601950;18500100;101850;0.99;0.01;7;38;40;0.95;1;1;18601950;18601950;0;1;0
278;natallyFile_161_C59500xV5800;345100000;59500;5800;33640000;16817100;16716991;100109;0.99;0.01;7;38;40;0.95;1;1;16817100;16817100;0;1;0
279;natallyFile_163_C60600xV6700;406020000;60600;6700;44890000;22441650;22431401;10249;1;0;7;38;40;0.95;1;1;22441650;22441650;0;1;0
280;natallyFile_164_C31300xV6700;209710000;31300;6700;44890000;22441650;22431401;10249;1;0;7;38;40;0.95;1;1;22441650;22441650;0;1;0
281;natallyFile_166_C22800xV3800;86640000;22800;3800;14440000;7218100;7216799;1301;1;0;7;38;40;0.95;1;1;7218100;7218100;0;1;0
282;natallyFile_167_C20600xV9000;185400000;20600;9000;81000000;40495500;40491501;3999;0.9999;0;7;38;40;0.95;1;1;40495500;40495500;0;1;0
283;natallyFile_168_C60200xV500;30100000;60200;500;250000;124750;124251;499;1;0;7;38;40;0.95;1;1;124750;124750;0;1;0
284;natallyFile_170_C76800xV3300;253440000;76800;3300;10890000;5443350;5441101;2249;1;0;7;38;40;0.95;1;1;5443350;5443350;0;1;0
285;natallyFile_171_C18900xV5900;111510000;18900;5900;34810000;17402050;17391545;10505;1;0;7;38;40;0.95;1;1;17402050;17402050;0;1;0
286;natallyFile_172_C18900xV5900;111510000;18900;5900;34810000;17402050;17391545;10505;1;0;7;38;40;0.95;1;1;17402050;17402050;0;1;0
287;natallyFile_175_C31300xV4900;184670000;31300;5900;34810000;17402050;17391545;10505;1;0;7;38;40;0.95;1;1;17402050;17402050;0;1;0
288;natallyFile_176_C50400xV6600;332640000;50400;6600;43560000;21776700;21765699;11001;1;0;7;38;40;0.95;1;1;21776700;21776700;0;1;0
289;natallyFile_179_C50400xV6600;332640000;50400;6600;43560000;21776700;21765699;11001;1;0;7;38;40;0.95;1;1;21776700;21776700;0;1;0
290;natallyFile_179_C33200xV3900;129480000;33200;3900;15210000;7603050;7601600;1450;1;0;7;38;40;0.95;1;1;7603050;7603050;0;1;0
291;natallyFile_181_C71300xV3500;249550000;71300;3500;12250000;6123250;6111250;12000;1;0;7;38;40;0.95;1;1;6123250;6123250;0;1;0
292;natallyFile_183_C6700xV6500;435500000;67000;6500;42250000;21121750;21110599;11151;1;0;7;38;40;0.95;1;1;21121750;21121750;0;1;0
293;natallyFile_184_C23900xV5100;121890000;23900;5100;26010000;13002450;13000100;2350;1;0;7;38;40;0.95;1;1;13002450;13002450;0;1;0
294;natallyFile_186_C62400xV4200;262080000;62400;4200;17640000;8817900;8815899;2001;1;0;7;38;40;0.95;1;1;8817900;8817900;0;1;0
295;natallyFile_187_C26900xV8000;215200000;26900;8000;64000000;31996000;31985100;10900;1;0;7;38;40;0.95;1;1;31996000;31996000;0;1;0
296;natallyFile_188_C67800xV6400;433920000;67800;6400;40960000;20476800;20465799;11001;1;0;7;38;40;0.95;1;1;20476800;20476800;0;1;0
297;natallyFile_189_C43100xV1900;81890000;43100;1900;3610000;1804050;1801199;2851;1;0;7;38;40;0.95;1;1;1804050;1804050;0;1;0
298;natallyFile_190_C42100xV7000;294700000;42100;7000;49000000;24496500;24484550;11950;1;0;7;38;40;0.95;1;1;24496500;24496500;0;1;0
299;natallyFile_191_C38000xV7200;273600000;38000;7200;51840000;25916400;25910399;6001;1;0;7;38;40;0.95;1;1;25916400;25916400;0;1;0
300;natallyFile_195_C16100xV7900;127190000;16100;7900;62410000;31201050;31166950;34100;1;0;7;38;40;0.95;1;1;31201050;31201050;0;1;0
301;natallyFile_196_C51000xV8800;448800000;51000;8800;77440000;38715600;38710499;5101;1;0;7;38;40;0.95;1;1;38715600;38715600;0;1;0
302;natallyFile_197_C51000xV8800;448800000;51000;8800;77440000;38715600;38710499;5101;1;0;7;38;40;0.95;1;1;38715600;38715600;0;1;0
303;natallyFile_304_C42200xV8900;375580000;42200;8900;79210000;39600550;39500101;100449;0.997;0;7;38;40;0.95;1;1;39600550;39600550;0;1;0
304;natallyFile_305_C45900xV9500;436050000;45900;9500;90250000;45120250;45100159;20091;1;0;7;38;40;0.95;1;1;45120250;45120250;0;1;0
305;natallyFile_352_C42300xV9300;393390000;42300;9300;86490000;43240350;43139149;101201;1;0;7;38;40;0.95;1;1;43240350;43240350;0;1;0
306;natallyFile_355_C53600xV9400;503840000;53600;9400;88360000;44175300;44102399;72901;1;0;7;38;40;0.95;1;1;44175300;44175300;0;1;0
307;natallyFile_356_C54900xV4100;225090000;54900;4100;16810000;8402950;8401850;1100;1;0;7;38;40;0.95;1;1;8402950;8402950;0;1;0
308;natallyFile_357_C42000xV2300;96600000;42000;2300;5290000;2643850;2641739;2111;1;0;7;38;40;0.95;1;1;2643850;2643850;0;1;0
309;natallyFile_358_C77900xV1100;85690000;77900;1100;1210000;604450;603250;1200;1;0;7;38;40;0.95;1;1;604450;604450;0;1;0
310;natallyFile_359_C43300xV8900;385370000;43300;8900;79210000;39600550;39500101;100449;1;0;7;38;40;0.95;1;1;39600550;39600550;0;1;0
311;natallyFile_362_C7400xV9200;68080000;7400;9200;84640000;42315400;41700005;615395;0.99;0.01;7;38;40;0.95;1;1;42315400;42315400;0;1;0
312;natallyFile_363_C45300xV3200;144960000;45300;3200;10240000;5118400;5109300;9100;1;0;7;38;40;0.95;1;1;5118400;5118400;0;1;0
313;natallyFile_369_C23000xV6300;144900000;23000;6300;39690000;19841850;19831450;10400;1;0;7;38;40;0.95;1;1;19841850;19841850;0;1;0
314;natallyFile_372_C44100xV4300;189630000;44100;4300;18490000;9242850;9241011;1839;1;0;7;38;40;0.95;1;1;9242850;9242850;0;1;0
315;natallyFile_374_C73500xV4000;294000000;73500;4000;16000000;7998000;7996599;1401;1;0;7;38;40;0.95;1;1;7998000;7998000;0;1;0
316;natallyFile_377_C82500xV1800;148500000;82500;1800;3240000;1619100;1607199;11901;0.99;0.01;7;38;40;0.95;1;1;1619100;1619100;0;1;0
317;natallyFile_378_C35600xV6100;217160000;35600;6100;37210000;18601950;18500100;101850;0.99;0.01;7;38;40;0.95;1;1;18601950;18601950;0;1;0
318;natallyFile_383_C99600xV1100;109560000;99600;1100;1210000;604450;603250;1200;1;0;7;38;40;0.95;1;1;604450;604450;0;1;0
319;natallyFile_384_C50200xV7900;396580000;50200;7900;62410000;31201050;31166950;34100;1;0;7;38;40;0.95;1;1;31201050;31201050;0;1;0
320;natallyFile_385_C58600xV5200;304720000;58600;5200;27040000;13517400;13514300;3100;1;0;7;38;40;0.95;1;1;13517400;13517400;0;1;0
321;natallyFile_388_C15600xV7100;110760000;15600;7100;50410000;25201450;25160320;41130;1;0;7;38;40;0.95;1;1;25201450;25201450;0;1;0
322;natallyFile_395_C62800xV3000;188400000;62800;3000;9000000;4498500;4491501;6999;0.998;0;7;38;40;0.95;1;1;4498500;4498500;0;1;0
323;natallyFile_397_C21700xV5400;117180000;21700;5400;29160000;14577300;14547099;30201;1;0;7;38;40;0.95;1;1;14577300;14577300;0;1;0
324;natallyFile_398_C64900x6000;389400000;64900;6000;36000000;17997000;17991001;5999;1;0;7;38;40;0.95;1;1;17997000;17997000;0;1;0
325;natallyFile_22_C31500xV7000;220500000;31500;7000;49000000;24496500;24464901;31599;1;0;7;38;40;0.95;1;1;24496500;24496500;0;1;0
326;natallyFile_25_C39200xV2700;105840000;39200;2700;7290000;3643650;3631349;12301;1;0;7;38;40;0.95;1;1;3643650;3643650;0;1;0
327;natallyFile_28_C95900xV4600;441140000;95900;4600;21160000;10577700;10465799;111901;0.99;0.01;7;38;40;0.95;1;1;10577700;10577700;0;1;0
328;natallyFile_30_C80700xV1500;121050000;80700;1500;2250000;1124250;1121150;3100;1;0;7;38;40;0.95;1;1;1124250;1124250;0;1;0
329;natallyFile_34_C1800xV7700;13860000;1800;7700;59290000;29641150;29541040;100110;1;0;7;38;40;0.95;1;1;29641150;29641150;0;1;0
330;natallyFile_36_C78600xV5500;432300000;78600;5500;30250000;15122250;15120101;2149;1;0;7;38;40;0.95;1;1;15122250;15122250;0;1;0
331;natallyFile_37_C54200xV8600;466120000;54200;8600;73960000;36975700;36964601;11099;1;0;7;38;40;0.95;1;1;36975700;36975700;0;1;0
332;natallyFile_39_C64700xV6400;414080000;64700;6400;40960000;20476800;20465799;11001;1;0;7;38;40;0.95;1;1;20476800;20476800;0;1;0
333;natallyFile_41_C35000xV5800;203000000;35000;5800;33640000;16817100;16716991;100109;0.99;0.01;7;38;40;0.95;1;1;16817100;16817100;0;1;0
334;natallyFile_42_C64900xV6100;395890000;64900;6100;37210000;18601950;18500100;101850;0.99;0.01;7;38;40;0.95;1;1;18601950;18601950;0;1;0
335;natallyFile_47_C38800xV8800;341440000;38800;8800;77440000;38715600;38710499;5101;1;0;7;38;40;0.95;1;1;38715600;38715600;0;1;0
336;natallyFile_48_C85100xV4700;399970000;85100;4700;22090000;11042650;11041650;1000;1;0;7;38;40;0.95;1;1;11042650;11042650;0;1;0
337;natallyFile_49_C64700xV7500;485250000;64700;7500;56250000;28121250;28101104;20146;1;0;7;38;40;0.95;1;1;28121250;28121250;0;1;0
338;natallyFile_50_C73900xV2900;214310000;73900;2900;8410000;4203550;4200599;2951;1;0;7;38;40;0.95;1;1;4203550;4203550;0;1;0
339;natallyFile_53_C47100xV9300;438030000;47100;9300;86490000;43240350;43139149;101201;1;0;7;38;40;0.95;1;1;43240350;43240350;0;1;0
340;natallyFile_55_C74200xV5800;430360000;74200;5800;33640000;16817100;16716991;100109;0.99;0.01;7;38;40;0.95;1;1;16817100;16817100;0;1;0
341;natallyFile_56_C60000xV4200;252000000;60000;4200;17640000;8817900;8815899;2001;1;0;7;38;40;0.95;1;1;8817900;8817900;0;1;0
342;natallyFile_57_C61800xV5900;364620000;61800;5900;34810000;17402050;17391545;10505;0.9994;0;7;38;40;0.95;1;1;17402050;17402050;0;1;0
343;natallyFile_59_C98500xV900;88650000;98500;900;810000;404550;403651;899;1;0;7;38;40;0.95;1;1;404550;404550;0;1;0
344;natallyFile_60_C54900xV6100;334890000;54900;6100;37210000;18601950;18500100;101850;0.99;0.01;7;38;40;0.95;1;1;18601950;18601950;0;1;0
345;natallyFile_61_C68600xV4900;336140000;68600;4900;24010000;12002550;11991399;11151;1;0;7;38;40;0.95;1;1;12002550;12002550;0;1;0
346;natallyFile_63_C68600xV4900;434140000;88600;4900;24010000;12002550;11991399;11151;1;0;7;38;40;0.95;1;1;12002550;12002550;0;1;0
347;natallyFile_65_C88300xV5400;476820000;88300;5400;29160000;14577300;14547099;30201;1;0;7;38;40;0.95;1;1;14577300;14577300;0;1;0
348;natallyFile_70_C61300xV3300;202290000;61300;3300;10890000;5443350;5431001;12349;0.998;0;7;38;40;0.95;1;1;5443350;5443350;0;1;0
349;natallyFile_71_C12200xV7500;91500000;12200;7500;56250000;28121250;28101104;20146;1;0;7;38;40;0.95;1;1;28121250;28121250;0;1;0
350;natallyFile_78_C41900xV2600;108940000;41900;2600;6760000;3378700;3376300;2400;1;0;7;38;40;0.95;1;1;3378700;3378700;0;1;0
351;natallyFile_81_C59900xV4900;293510000;59900;4900;24010000;12002550;11991399;11151;1;0;7;38;40;0.95;1;1;12002550;12002550;0;1;0
352;natallyFile_1_C36000xV8400;302400000;36000;8400;70560000;35275800;35235501;40299;1;0;7;38;40;0.95;1;1;35275800;35275800;0;1;0
353;natallyFile_2_C25900xV7700;199430000;25900;7700;59290000;29641150;29541040;100110;1;0;7;38;40;0.95;1;1;29641150;29641150;0;1;0
354;natallyFile_4_C74300xV3800;282340000;74300;3800;14440000;7218100;7216799;1301;1;0;7;38;40;0.95;1;1;7218100;7218100;0;1;0
355;natallyFile_5_C65800xV7400;486920000;65800;7400;54760000;27376300;27371291;5009;1;0;7;38;40;0.95;1;1;27376300;27376300;0;1;0
356;natallyFile_6_C82400xV2500;206000000;82400;2500;6250000;3123750;3122550;1200;1;0;7;38;40;0.95;1;1;3123750;3123750;0;1;0
357;natallyFile_8_C32200xV4900;157780000;32200;4900;24010000;12002550;11991399;11151;1;0;7;38;40;0.95;1;1;12002550;12002550;0;1;0
358;natallyFile_11_C12700xV10000;127000000;12700;10000;100000000;49995000;49988451;6549;1;0;7;38;40;0.95;1;1;499500;499500;0;1;0
359;natallyFile_12_C42800xV2700;115560000;42800;2700;7290000;3643650;3631349;12301;1;0;7;38;40;0.95;1;1;3643650;3643650;0;1;0
360;natallyFile_14_C62800xV7000;439600000;62800;7000;49000000;24496500;24464901;31599;1;0;7;38;40;0.95;1;1;24496500;24496500;0;1;0
361;natallyFile_16_C29700xV9300;276210000;29700;9300;86490000;43240350;43139149;101201;1;0;7;38;40;0.95;1;1;43240350;43240350;0;1;0
362;natallyFile_17_C86300xV5800;500540000;86300;5800;33640000;16817100;16716991;100109;0.99;0.01;7;38;40;0.95;1;1;16817100;16817100;0;1;0
363;natallyFile_18_C23800xV5200;123760000;23800;5200;27040000;13517400;13514300;3100;1;0;7;38;40;0.95;1;1;13517400;13517400;0;1;0
364;natallyFile_19_C17400xV8300;144420000;17400;8300;68890000;34440850;34430649;10201;1;0;7;38;40;0.95;1;1;34440850;34440850;0;1;0
365;natallyFile_20_C40800xV8700;354960000;40800;8700;75690000;37840650;37820549;20101;1;0;7;38;40;0.95;1;1;37840650;37840650;0;1;0
366;natallyFile_21_C89400xV3500;312900000;89400;3500;12250000;6123250;6111250;12000;1;0;7;38;40;0.95;1;1;6123250;6123250;0;1;0
367;natallyFile_22_C31500xV7000;220500000;31500;7000;49000000;24496500;24464901;31599;1;0;7;38;40;0.95;1;1;24496500;24496500;0;1;0
368;natallyFile_25_C39200xV2700;105840000;39200;2700;7290000;3643650;3631349;12301;1;0;7;38;40;0.95;1;1;3643650;3643650;0;1;0
369;natallyFile_28_C95900xV4600;441140000;95900;4600;21160000;10577700;10576199;1501;1;0;7;38;40;0.95;1;1;10577700;10577700;0;1;0
370;natallyFile_30_C80700xV1500;121050000;80700;1500;2250000;1124250;1121150;3100;1;0;7;38;40;0.95;1;1;1124250;1124250;0;1;0
371;natallyFile_34_C18000xV7700;138600000;18000;7700;59290000;29641150;29541040;100110;1;0;7;38;40;0.95;1;1;29641150;29641150;0;1;0
372;natallyFile_35_C78600xV5500;432300000;78600;5500;30250000;15122250;15120101;2149;1;0;7;38;40;0.95;1;1;15122250;15122250;0;1;0
373;natallyFile_36_C54200xV8600;466120000;54200;8600;73960000;36975700;36964601;11099;1;0;7;38;40;0.95;1;1;36975700;36975700;0;1;0
374;natallyFile_446_C32200xV5100;164220000;32200;5100;26010000;13002450;13000100;2350;0.9998;0;7;38;40;0.95;1;1;13002450;13002450;0;1;0
375;natallyFile_448_C25600xV8600;220160000;25600;8600;73960000;36975700;36964601;11099;1;0;7;38;40;0.95;1;1;36975700;36975700;0;1;0
376;natallyFile_449_C41300xV7200;297360000;41300;7200;51840000;25916400;25910399;6001;1;0;7;38;40;0.95;1;1;25916400;25916400;0;1;0
377;natallyFile_450_C18300xV4900;89670000;18300;4900;24010000;12002550;11991399;11151;1;0;7;38;40;0.95;1;1;12002550;12002550;0;1;0
378;natallyFile_452_C70000xV4600;322000000;70000;4600;21160000;10577700;10465799;111901;0.99;0.01;7;38;40;0.95;1;1;10577700;10577700;0;1;0
379;natallyFile_454_C54900xV7600;417240000;54900;7600;57760000;28876200;28855199;21001;1;0;7;38;40;0.95;1;1;28876200;28876200;0;1;0
380;natallyFile_455_C50500xV1900;95950000;50500;1900;3610000;1804050;1801199;2851;1;0;7;38;40;0.95;1;1;1804050;1804050;0;1;0
381;natallyFile_457_C67400xV3800;256120000;67400;3800;14440000;7218100;7216799;1301;1;0;7;38;40;0.95;1;1;7218100;7218100;0;1;0
382;natallyFile_458_C89200xV8700;776040000;89200;8700;75690000;37840650;37820549;20101;1;0;7;38;40;0.95;1;1;37840650;37840650;0;1;0
383;natallyFile_430__C88400xV8500;751400000;88400;8500;72250000;36120750;36110650;10100;1;0;7;38;40;0.95;1;1;36120750;36120750;0;1;0
